20 5 1
*****
*   *
*** *
*   *
*   *
* ***
*   *
*   *
*** *
**S *
*** *
*   *
* * *
* ***
*   *
*   *
*** *
*   *
*   *
*****
